
NO ./textures/wall.xpm
SO ./textures/wall2.xpm
WE ./textures/wall3.xpm
EA ./textures/wall4.xpm

1111111111111111111111111111111111111111111111111111111111
1000000000100000000000000000000000000000000000000000000001
1011000001000000000000000000000000000000000000000000000001
100100000N000000000000000000000000000000000000000000000001
1111111111111111111111111111111111111111111111111111111111