
NO ./textures/wall.xpm
SO ./textures/wall2.xpm
WE ./textures/wall3.xpm
EA ./textures/wall.xpm

C 0,100,255
F 180,200,0

11111111111111111111111111111111111
10000000001000000000000000000000001
10110000010000000010000000000000001
100100000N0000000000000000000000001
11111111111111111111111111111111111