
NO ./textures/wall.xpm
SO ./textures/wall2.xpm
WE ./textures/wall3.xpm
EA .././textures/wall4.xpm

C 0,100,255
F 180,200,0

1111111111111111111111111111111111
1000000000100000000000000000000001
1011000001000000001000000000000001
100100000N000000000000000000000001
1111111111111111111111111111111111
