

NO ./textures/wall.xpm
SO ./textures/wall2.xpm
WE ./textures/wall3.xpm
EA ./textures/wall4.xpm



F 220,100,0
C 225,30,0


1111111111111111111111111
100000S000110000000100001
1011000001110000000010001
100100000000000000000000111111111
111111111011000001110000000000001
100000000011000001110111111111111
11110111111111011100000010001
11110111111111011101010010001
11000000110101011100000000001
10000000000000001100000010001
10000000000000001101010010001
11110111111111011100000010001
11110111111111011101010010001
11000000110101011100000000001
11111111111111111111111111111